00000f0000f0000
00ww0ww0ww0f0w0
000www00wwwwww0
00f000f0000w0f0
0w0w0w0w0w0w0w0
0w0www0www0www0
00000000000f000
000000w00000000
000000w00000000
000000wf0000000
000000wwwww0000
000000w00000000
000000w00000000
000000wf0000000
000000wwwww0000
